-----T--E---X-XEB---B-B---B-M-------------?---ET--------o-----B---B-----------------------B-------?-------T-----X--B--B---------B-----------T-----------B-M--------------------------?------------------
----oB---------M-------B-----------------E---TEB---B-------B-----B------T--E-----------------M-------B----T------?---E-------B-B---B-----B--?---o-----------X-?E-----M--|o-----B-------------o----------
--o----BT|X-----------E---B-----------------B|--B---T-?-o-T-------oXXXoMB---?-----------------B----?--B---------M-o--Eo-o--------TB----------X------------o---------B---B---B-----X---------------------
--------BB---------------T-o-B-----B-------B-B------X-----?-BB--B----B-X--XB----------------o--B---oBB-B--?--B-------o---?M-?M---B---------o--B--B-B-B-------B-BT----X--B?---------B-------B---------X--
--M--M--BBX---B-E--------X--X--------X---T---T---|---B--B-o-------o------------------|B--------o--------T------E------B--------------------|--Xo-----------E----X-------B|--M-------B---B--------B------
-------M-?M--B------B--o----------?-T?-----X-B---B---------E--------XB---MTB---------B-------B--------T-M--------------B-XoB---------------B---o---T---B-X-------X-------X-o--T--?-----B---B-B-------B--
------B--X------B--X----------------B-----T---B------?--B-B------?--------?BB-B---X---B----?----B-----B---B--o--------B---------M------------------XB---------B---------?---B-B-----?--|--T-B-----------
-T-----------MX------o-----B-B------------X----B-------B--B--B--B----------?-B-B-BT-----BB---B---------------?-----B----------X-B--------M-B---XB-----------X------B-o-B-T-----------B-B--MB----------Mv
-?--------B-X-------M-M-----B-------------B-------B---o---------?-----------B-----B---B---------BE-----------------X----Bo?---------------B-B---------B-----B-------B|---|-----------?----B-------B----f
-?---B-B------------?----o---B-X-------X-X-----X-------------B-------M----o-B----------B------X--B---B------B----------?-----B---------B-B--?-----|----B-o-----------B--|B---o-----------------o-------f
-----------------?--B-------o--T----------E?-----T--B----|---------------X----X-----M-------B------|o-------B?------------o---B-------B-B---B---B-B-B---B-T---------MT--B-----B---B---T-o--------------f
-B-----oM-------X----B---o-----T---o---------T---B-------B---o----------B--------M-------T---------B-------B---------B-----E-----------?-X---------M-B----T--B-------B-----B-B--------M----B-----------f
--B-------B-T---------B-M------|----B--TB-B-?X----B------B--o-B-B-M-B-----------B------ooM---------X-o-----------?---X------------?-B----X----B---B-----B-B------B--------------------B----------------f
-----o-----EX-----X-E-B----B-?-B-------BB--B-B-T----?--------B---BM-X--------------B-?-----BT---X-X-----------X--B-o--T----B----E------------B-Bo--B----?---------------T--o-o--------XB---------------f
m-X------T--B-----B----ME---T-----B------------M----------?B--BX------------B-B---------o---?--X-TB-----B-----B---BB--B-B-----?-----o-------------------B---------------B-----?-------------------?----X
XXXX-XTX-XX-XX-XX-XXX---XX-XXXXXXXXXXXXXXX-X-X-XXXX--XXXTXXXXXX--XXXXXXXXXXXXX-X---XX-X?X-XX--XXXXXXTX-XXXBXXX-XX-X--XXXEX--BXXXXXXXXX-X--XXXXXXXXXXX?XXXXXXXXoXX-XXXX---X-XMXXXXXXXX-XX-XXXX--XXXMXX-XX
