----------o------------------------B----E-----------------E-M---------------------E-M-------------B---------E-M---------------E---------------E-----?-------------o-----o-----E-B-----B-----------M-----
---------------------------E-?--------EE------o----------T----o--B--E----M-------B---o-o--X------B------B-B----E-E----B----B-B----------------E----------------------o----?ET--o---E-----B-E---------E--
--------------?-E-----X-B-X-E------------------B----o---XMB-----E---B-?-X-----X-EBB-E-X-E--B--X-----------?-------------B---------B-X-B-----------------E---------------T-E-B-----E----------------B----
---B-----------E-------E-T---E---E-----E-----B-----?-E-T-B|E-----E-----B-------------E---------B-ET--Bo------B----X--B---EB--E---T---?-E-----?-------------------------?B---------o---oo----oE-----E-E--
----o---B--X------------EB--------B---------------o---o|--T-------E-----X-B-------------------o-?-BB--M-E-----E-TX------o-B------|--------B---TE--------------------o-------------------------o-E-------
-----E---E---X-T---o-----X------------------?E---------B--M--E?------o-T-------M-----X----------------T--E-----EBE-T-M---B-------B---------B--T-----------E---?E---T-----B-------------ME---B----B---?--
---------------BEE-T----------------------B-------M---E-----------E---BT--B-B---T----------|-?-----T-?XoT-------B--T------E---M---E-X-----E-o-B---o-B-------------E?----M-------------E---E-------?-B---
-----?---------B-E-------E---E-------------------E-B---B-B---E-----?---B---B----X-?M----T----E-E--B----XX----------B---E-E-----------BTo---E-E-------M-------------E-------------------B---E-------E--Bv
------------o-B---------------------E-E---B---E-----T-----------T-----B---E-----T-X-----B-E--------M----B---M-------------B-E-B-------B-----B-------E-E---E-B------------------T----------?T--------B--f
---X-B-E---E---E-E-E-X-------B-M---------------o----|--E--------M---EE------MX-?T-oE-E-B---B---E-------------------M---------------E-o-B---------------?-M-----------B---B-?-E-B-----ME----B-------E---f
----------?---E-----B-oo----BM----------o--o--------B--------o--BTT---M-E-------B-E---------E-E-------o-B----?----------------T---------o---------E-X---B-?---E-----X-------------B---E---B-E-M---E----f
---------------------B-E---E---M---o-?-?--------?---X-?B---E-E---BT----E---X-----X-----X-T-------------B----------?--B-B---?-TTo-E-------T---M--|--------------o-------------T-------------X---B?E-E---f
------------E-o---X---E---------T-----E-----o-------------o---B-B-B-o-?--M---------------|--------T-------E------B----B------?E-------o--M----B---------BB----------T-----XM-X--------B---E----|B------f
---------------B---------------BXT-----o-----B---E-------------M?X-o--?---|--M-------E-E---E-o---TB-----o--?---M-------E-----BXE---------B---B-E-----E-E--o----o--T-M----T---T--------------|--B-------f
m-----B-----B------------o------TT--o-T-o----M--E----|--------------?---------------E---o-----E--?----E---------------------B--------------T------E-----B-EBM---X-B-B--|E?---XE-------T-T---B-X--------X
XXXXXXXXX-X-XXX-XXX--XXXXXXXXX-XXXXXTX-X-XX-XX--XXXXXX-XX-X-XXXXXXXXX--XX-XX-XXXXX-XXXXX--XXXXXXXXXXXXXXX-XX--X----XXXXXX--XXX-Xo--XXXX-XXXXX-XXX-XXXXX-XXXXX-XXXXBXXXXXX-XXXXXXXXXX-XXXXX-X-XXXXXXXXXXX
