-X-------E-X-o-----X-------------------Mo------o---B-X-----------T-------X-------------X---------T--o--------------------MX--T---------------Xoo-----X-------M--------?X--B--------------X-----E-X------
--------------X-T-X-----T-----------X---------------------o------------M--B------B------B-----T-XBE-----X-M----Bo--------To-o---X-----X-----|---E-T-------o---T---------o---X--------------------o|-----
-----X-X----TE-----?-------oBX-?---------X-E-?---------X--B--T---MB---BT---------X-----X-M-----?---X---?-----T---X---X---TTE-B----BX--o---------------T---B----X-----XB------------?---X----------Bo-X--
-BX-oB--T-T-TBT-E-X-------o-X------o--X-E---------X-M--B--X--E---------B-------B-B----X--------B----|B--------------oBo---T-----?-------X-?-?---------B---------?-----M---X---------------XM----o---X---
---?-o-----------XM------TT-------B------E-----E-----------E--------------BX-X-X--------------------B----TB-------B-----B-BX--X--M------B--B--T--X---o-----X-E-X--------B-----X------M--o-o-BBo--X---X--
-------T?BX---?----TX----B?--------B--------------X-------B--------B----X-------------X-------?-MT-MB---X---X-----T-X----BE-------X--------B--T---?-M--------------------B------X-------------X--B?-M---
---|---?-----------?------X------XBX------BB--B------X-T-------?-?M-----B-BT---X-----M-X---B-----T------B-----T------------X--Bo---------X-X---M-----------------B---------------X-X-X---X--B--X---oX---
--------------X-X--B----T---o-------T-----M---X----B--o-----E--BX-X-------------X---------------------|-------?----B--X---X-----X-X--BB-----T-B---XX-----B--Xo-----B---BB-------X------TX-M-----X-X----v
-|-T-T-----XE-BX-------------TBM-----X--X--X-X-------X----------B--T-M-----BT---B-B?-E-T-----M---------o------|X-B-X-M----B--XB--------T-----|-------oB-----B------------?-X-----X-----M-----X---------f
--------------o-X--BT---------X-------------E--------------B--M------B------?---??---B------------|----------T--X-?-X-X-X-------E-X-----------X-------X-|-T---X------BB--B--M-o---T------------------oMf
-------o---------?-?--B--B--BXM---TX---TB----|--B--------XB--X--BX----------B-B--X-----------B---------TTX---|M------T-------X-----------?-----------X---------o-o-----X-------E-B-------------B-------f
-BT-------o---X--BXo----MB-----B--X-o--?-----MX---X-------|---T--------B-B----X-XBo-MT--?-----?B--X-----|----B------------o-----?---X--B-B----T-----X--BE-?--Xo-X-----XB--E---X-------?o------TB?-|----f
-----------X----B--XBX-----X---T-X---------X-M-X----------B---B---T--X-M-------------MB-BM-?---X---B--?------?---o---B-----E-----------------MB------o------B--------------o---X-o---TB----X------B----f
--X---?---E-B-------X-------------M---X---?B-B------X-X-----------?---------o-o-----Xo------------------X--------------------B---B----------------------T-------------------------X-XB?-----o---o------f
m-o------X---------T-X-M-|-----BBE--Bo---o-BBM-?-----X---M---T---------X----------E--T-X--Bo-M--------T--------B------B----?-------------T-B-MBX-o---------------X-----------XB-B-BX-E------?----------X
XXXXXXXX-B-XXXX-XXXX-XX-TXXXXTXXXXXX--X-XX-XX-XX-XXX-X-XXMXBXTXXXXXXXXXX-XXXXXXXXXXXXXXXX-XXXXXXX-XXXX-X--XXXX-XXX-XXX-XXXX--XXXBXXXXXXX-XXXXXXX--X-X-X-XXXXXXX?XXXXXX-?XX-XXXXXXXXXXXXX-XX-XXXXX-XXXXXX
