--o--T----------------E------------------------T--------X-----------------------------M-----------X-----T----B----oB--------------B-----------------B-------------o-------------E----?------------M-----
----o------------X--------EB-----E-------B----E--------------------o---BT--------B---------T---B---X-T--T-|------------B--------------------T---------------X-?----------------------o---B---------o----
-------B------o-------B---M-----------o------B---------------------X--T-B-----------B-----BT----?--?-?------X-------BX--B-o-X-B--TB-B-T-B-------------B-------------------------------o-----------------
--------|o-T-----B-------M-------------E-o-------?--X----TBo---oB--B--|B--X------X---------Bo--B---?-B-----------T--------M??----B---B?----o-?X-o------o-------B-----------------------------B-B--------
--?--M-----M----------o--T----------B----T--T---X|--?----B--B-B-----------?--------------------oM-----T----------X------------?-------?-B--B--Bo--------o--E--------B-B-B|--------B-M---------B--B----E-
-------B-BMB---T----B----B----------T----B--|----------B-B-----B----X-----TB-----------------------o-T?-?--------B-------Bo------B---------B-------------------B-------------o--------------------------
--------------BM---X--------------B-----B-B-------E---------X-B-----B-o----B------T---B----?--B------M--T-X-Bo--B---------B-B---X-------X---E-------------B-------?---------------B---X|B---------------
-B-----E------X?---?---------------o------T------------?--BX----------------------M----BB------------B--?------B---B----------X-B---------------B-----------X?-B---B---B-----?---M-----B--|-----------Mv
-M--------o-------------------E-------------------o-------------M---------------B-B-------------BX----------?---B--X-----oM-----------o-------------------B----------|---B--B-X-B-B-B?----B-----------Xf
---------------E-------------T-------B---------B---B---E-o-------T-----M--o-B--------T-----B--X--?-X-----B---------B-------------M-------B-B?------------------?-----o-------------------------------X-f
------B-o-----------M---B---BB----------------o-TT--T---E|-------?-------X--B-B-----oM------B------|B--------?T-----o-----o-----B-----?-E-----B-----------?----------To---B---B---B-------B---------o--f
-----B----------X------------B-----B---B-----B--|--BX----------M---B---?BT-----E-B----------oB-----o----------B----------o-----------E-?-B-------------B--|--------T-E-------E--------B----------------f
------B-----o---o-B---B--------M--B-----?---E|--B-----M--B----X-X-BXB-T--M--B----------o-B----E----X-------------T--o-----B---T-----o----X----o--------------------B----B-----------E-B---------X------f
-----------XX----EX-E--X-B---B-o---B----B----B--T---?T-----?---T-EM---X------------------E-ET---X--B---------BX-------T------BT-E--------o-T-o-Bo-------?-X----o---B-B-oTX---------B-BX------M-B-------f
m-----o--T----------o--M----X-----X---------B--T-----X------B--??-----B-----o-E---X-------o-B--X-TB----------------B--T-------T-----------TM------B---------------------------------B-B---M-B----------X
XXXX--XXXXXXXX-XXXXXXX-XXX-XXXXXXXX--XXXX-XX-XXBXXX--XX-XXXXXXXX-XXXXXXXX-XXXX-X-B-XX-XXX-XX-XXXXXXXTXXXX-BXXX-XXXXX-XXXEX-X-XXXXXXXXX-oXXXBXXXXXXXXXXXXXXXXXX-XX-X-XXXX-X-X-XXXXXXXX-X--XXXX-XXXXXXXXXX
