------o----------------------------B--------------M-------------------------------------------------?-----------------E----------M----X-------?---------------------------------------------------------
--------------------------------------E-------o---------------o-----E------------B--------X-------------B-B-----------BB----------------------E---------------------------?-T--------------o-------o----
----------------------B-------------B---------BB----B----TB---------o-B----------BM-B-----BB------------B-----------B---T-----B---B-B---T-------B---------------------------B----------------------B----
-------------------------B---?-----------------B-----B---B|----X-------B-------------------B---B--T--Bo-----------X-----|--------B---B--B--M-------B-----------B--------X------B--oM--o-----o-----------
-----------X-------------MX---------B---------------B--B--B-o-?-------B---B-----B-----------------BB--------M-o--X------B-----o--B----B-------BE------?-------------B-------------B-----------------E---
-------B-----------------B------------------?-------------B---?B-o---------B-------?------------------T------T--?--------B---------o----------X------X----E---?-------------------------E---B-----------
--------------BMME-T--?-----------B-----B-B-B---M---B---------B-----B--E-------------------|-?-----T-?BoB---B|-----|--------B---B---------------------------------BX------------T-------B---------------
-?---X-------------B---B--o-------o----------o-------------o-------------E------M-?----BT--B------BB-B-TM----B-B-----B-----------o-B--T----------B---X---------B-------B--------X---------------------Bv
--------------------------------------M-------------------------B-------------B-----------------B--M---|B---B-------------?-----------B-------B-----------B--------------------TB-B-B------T-----------f
-B-------------------B-B---------------B-------B----|----?------T---E----T--M---|----B-------T---M-----B---E---------------B-------------B-----------T-T-----------------B-----B------E----B---------B-f
--M---T-----o-------X-ToB---BM--T----------o----B---B---B----o--BT-------X----B-B------------|------B--------?B---------------o-B--------------------|-T------------------B---B---B-?-----B------------f
-----BM---------------?---------?--B---B-----B--?--BX-?----------BBB-----B-------B-----------T---------------?----?-----------?--------B-B------|----B-X---------------------o------------------?------f
----------------o-B---B---------B-B--------------------------------------M--------------BB---X---B--T------------BT-------B--TB-----B----B----B-B--------B------------B-B--M-T--------B-----T--|-------f
-----------B---o-------B-B------M--B---------B---------------B--?-----?---|---T----M---------B------T---o--------B?----------BX----------------B---------Bo-------TBBB-------B-------B-----o?--B-------f
m-----------B------------o-------X-----------M-------|--B-----------------B---M---B---------B----MB-----------o-o-B------------------------T--------B------B------B----|-X------o-X-B-B---B-B-------B--X
XXX-XXXXX-X-XXX-XXXX-----XXXXX-XXX-XTX---XX-XX-XXXXXXX-XXXXXXXXXXXXXXX-XXXX--XXXXX-MXXXX-XXXXXXXXXXXXXX-X-XX-XXX-X--X-XXX--XXX-Xo--XXXo-XXXXX-XXXXXXXXXXXXXXXXXXXXB-XXXBXXXXXBXXX-XX-XXXXX-X--XXXXXXX-XX
