-----------------------------------B--------------o-------------------------------------------------------------------------------------------------B-----------------?---------------------------------
--------------------------------------E-------o----?----------o-----E----------M----------X-------------B-B-----------B----------------------?E---------------------------?-T------------B--------------
-----------------------------------------------B---------T--------------B--------B---------B----------B---------------------------------------------------------X----------------------------------BM---
-B-----B---------------------B-o-------------B-----------B|--------------------M-----------B---B--T---oB----------X----M--B------B-----------------------------?--------XB--------o---o-----oB----------
--?--------X-------------M----------------------B---B--B--B---------------------------------------BB-------------X--------B------B-------------EB---------------------------------------B---------------
-------B---------------o-----------------B-E?-------------B---?---------------------------------------T---------?B-------------------------B--X-----------E---?-----T----B-------B------E--oB-----------
---------------M-E-T?---B-----------B---------------------T-------B----E--B----------------|-?-----T-?Bo-----------|----?-----------------------------------------MX|-----o-----------------------------
-------------------B---------B---------------B------------B------E-------------?MB?-----T--B------BB----M-oX-------B------------------TB-----------B-----------o----X------------------B-------------BBv
--------------------B---------B-----B-------------------------B-------------------------B----------M--------------M-----B-----------B-B-----T-------B-----------------B--------T----B-----BT?---------Bf
-----------------T-X---------B-----o----------------|-----------T---E--B-o--M---|-o----------------------o---------------------------------X?------------------------B---------B------E----B-----------f
----------E------B-----o-----MB------------o--------B--------o--BT----------B---B-------?--------------------?------------------------------o----------------------------------------------------------f
---------------------B--------------------------?B-EX-?--B-------BBT---M--------------B---------------------------?--B--------?-----------------|--------E-----------B---------------------B----?--B---f
----------------B-T---------------------T---B----------------------B-----M---------------B-----------------------B-----------T------B----B------B--------B----B------------M-T--------B--------|-------f
------------------?--B----------M--B----X--------X-----X-----B--?-----?--B|-----------------------------o--------B-B-----B---B----------------------------o-------T-B--B-----B-------B------|--T-------f
m---------------B-------Eo-------X----------MM----?--|--------------------B-----------------B----M--------------------T---B--------------o-T---------------BB-----B----|-X----------B-------B----------X
XMXX-XXXXXXXX-X-XXXX-XXXXXXoXX--XXX-TX-X-XXXXX-XXXXXXX-XXXX-XXXXXXXXXX-XX?XX-XXXX--XXXXX--XXXXXXXXX-XXXXXEXX-XXX-X-XXXXXXX-XXX-XoX--X-XXXXXXX-XXXXXXX-XXXXXXXXXXXXBXTXXXXoXXXXX-XXXX-XXXX--X-XX-X-XXXXXX
