-----To----------------------------------------T--M-------------------------------------------------?-----------o--B--------------?---X------------------------T---------------------?------------------
----o-----------------------------------------E-------------------------T--------B------------------------|------------B--------------------T---------------XB??---------------------------o-------o----
-----------o------------------------B--------BB-----B-----B--------Xo-B-----------M----------------?-----------------X--T--------TB-----T----o----------------------------------------------------------
--------|----------------B---------------------B----XB---BB----XB------B--X----------------Bo--B----BB------------------B-M------B------|--M--X----B---------------T-----------B---M--------------------
-----MT-----B------------T----------B----T------B|------------?---------B-------B--------------o------------?-o---------B------------------B--Bo------?----E----?--X-----|-----------------------B--E---
------MB--MT--------B----B----------T--------------E-------------o--X-----T----B---o---------------B--T------T---------T-Bo----------------B---------X--------------------------------------------------
------M----X----M--X--?-------------------B-----M-------------B-----B------B--------------X?----------B-B----X---------M------------------o---B---------------------------------T-----M|B---------------
-?-----------oX--------B---------E---B----T--o------------B------------B-E--------------BB-----------B-T-T---o-------M--------X-Bo-B------------BB---X------X----------B----E-o-B---------|---B-------Mv
-M--------------X---------------------M---------------------------------------B-B-B-B------------X-----XB|---------X-----o?-------------------B----------------------|--EB------B----?-----------------f
-B-------------------B-----------------B-----------------?---------------T--B----------------T---M-----B---E---------------B-------------------------T-T-----------------B-----------------B---------B-f
--M---T-----o-------X-T-----B---T---------------BT------B|---------------|----B--------------T-----|---------?--------------X-o----------------------B-M-------------T----B---------?------------------f
-----BB---------X-----|------B--TX-B---------B-------------------B------BB-------B---------o-T---------------?-M---B-------------------B-B-------------X--|--Bo-----------------------B--------------o-f
----------------------------Bo-M--B----------|-----------B--------BX-------------------oBB---?-----X-------------TT-----B-----B-----B---BX----B---B-------------------------------B---------T----------f
------------X-----X-E--B----------------B----B------?--?-----B----M------B---------M-B------T---X--T----------X--B|---T---------E---------------o-------?BX-------------T-------------X----o|----------f
m--------T-------------M-----------------------T--------B----M-X--------------M---B------------X-T-B------------o-BB--------------------------------B-----------------?-----M---o---B-------B----------X
XXX--XXXX-X-XX-oXXXXX---X--X-XXXXXXXXXB-XXX---XXXXX--XXXXXXXXXXX-XXXXXX--XX-XX-X-X-MXXX-XXXX-XXXXXXXTXX-X-B?XX-XXXXX-XXX---XBXXXX-XXXX--XXXXXXXXXXXXXXXXXXXXXX-XXXX-XXXX-X-X-BXXX-XXXXXX-XXXXXXXX-XXX-XX
