-o-------------X-------------------B-----X--------o------B---------------B-------T-------------------o-----------------------X----------------------B------B-------E--?------------------------B---M----
------X-----B-----X-B-|-o-----E-----B-M-----E-B---M?M-----T-?---------T--------M----T---M-T-------------|-M---------T---T---B-|---T-T---|---??----X---------?---------------------E---M-oB?---------X---
---o-----B---------?-----B-----B---E-?-----E-X-------M---B-B-----B-----TB--------M-----------B-B------B------B---------?---------|---T-E-----B-----------------TX----M---B-----M-X---X-----o------------
-BB----B--B-T-B-------B------Boo--B-B--------BB-----|-----M-|-T-?-----|---|-E--MX---------BB--MB----------M------------MX-B------B--X-|-?-B---T-B--------------?----T---XBX---B-M-|---------BB----------
--?----T-|-B?--B-B-------|-----------B-B---?----BB--BM-?-M-----T-o-------?-|-------B-B-----o---B-------B---?---B-B-------TB----?---------B-----BBB-------B-----T-------E-----E-------------------B-?----
------E---o---|--------o----M-----T-B---|BTE|---X-------------|-----?-----B-------B-------o---M---B---?-M---|-?--BB-----B---T---|-------o--B------B---------------|------B----?-EB|-----T--o----o---o---
---------?---------o?--XB?-------o--BB-M-----------------XT-------B----B--B--X---------|-|-------B---?-M-----B-T-B-B-B--?o---o-----M-----?-B---B---------B-?---T--M?---T--oB-----------E---X-o-----B----
--X---M---?---M-------B-B---XBo-----------X--B------B-----|-----TEB---------B-X?-BB-B-B---------T-------T--X|---?--B------T------------B--o---X----B------T----o----o-----M-o---M-|-|--B--M---X------B-v
-X-o---o---X---o-o--BM-T------B-----B--X-------|-M-X----------B----B-X---o-----------T-?-X---X---B-----?-M-M------M----MB--M---B-B--B--M-T--T-------B-----------------B--T-o---B----BB----B-?o--------Bf
--o---o---B-B-B--T------|-E-TB----X---------------B-T---M---?---------XB-o----T-B-------------------|o---oB---T-----------------T----------X?-----M-----?-----------EB--B-----|---|---o---T-B---------Bf
-----T----E------M-------X-M-MBB-E-T---T-B-X-T-----T---------?---T-|---X-?-BB----T-----B-o---T-B-----B-?-?-o---X---B-------------------?-T-Bo--------B-T-B---o-----B---------T-----o-------?-------?-B-f
--o-B-X-B-----M-?-|--B|-----B---T-E-----?-------XBo|--E--BX-----XB-TB-----------?-------B-------------------M---X-B--Bo---T-B-B---o--?o-B-B-------------MEB---B-M-B-EBB-T-----B---B---M---MBB------B---f
---o---?---|---BBBT----|-T-----?---T----T---B?-----|---X-?---------?-----X---------------X-?-T---M---X-?-X-------M-X---?-B---B---M--B--B-E-----|---B-B---B-X-BB--M-|-|-------B-?-----|B--------T-------f
--?-B---B---|-----X--BM-----B-X---BB----X-----X--X-?---XX----B----E-B-X--B--?---B-B---------|---B-T-M---------X--B?B--?--B----B-----M-?-B---------X-?-----B------------B------B-M---BBT-B-T-B-------M-Bf
m----------B----B--B----E----------X---B----M--T--?--X-----B---------------B-----|---B-B----B--B-----M---B-------o----T---B--------T---o---T-----T-M---B----B--X-------X-----X-o----B-------BB---------X
XMXXXX-X-XXX--X--X-X-XXXXX---XX-XXX-XXXXXXXXXXXX-XXXXXXXXXX-XX-XXX-XXXXXX?XXXXXXX-XXXX-XX-XXXXXX-XX-XX-XXEXXXX-XXXXXXXXXXXXXXXXX-XX-X-XXXXMBX-XXXXXXX-XXX-XX-XXXXXXXXX-XXoXXXXX--XoXXXXX-X-XXX--X-XXXXXX
