-o-------------X--------------X----B-----X---------------B---------------B-------T------------E------o---------------------B-X-B-----------------------------------E---------------------------B---M----
-----MX----BB-----X-B-|-o-----E-----B-M-----E-BT--M-M-----T-?---------T----------B--T---M-T-------------|-M----B-B--T---T---B-|---T-T---|---?----oX---------?---------------------E---M-o-?-------------
---o-----B---------M-----B----?B---E-?-----E-X-T-----M---B-B-----B--B--oB--------M-----------B-B-----------------------?--T------|---T-E-----B------------B----T-----M---B--B--M-X---X-----o------------
--B-------B---B-------B-------o---B-B--------BB----B|--B-BM-|ET-?--B--|---|-E---X---------B---M-----------M-------------X-?------B--X-|-?-B---T-B----------------B--T---X-X---B-M-|---------B-----------
-------T-|-B---B-B-------|--------B--B-B---?-----B--BM-?-MB----T-o-------?B|-------B-B-----o---B--B----B---?---B-B-------TB----?---------B-----B-B-------B-----To------E-----E--------------B----B-?----
------B---o---|----T--------M-----TBB---|BT-|---XB------------|-----?-----B-------B------EoT--M---B---?-M---|-?---B-----B---T--B|-------o--B------B---------------|------B----?-E-|-----T-------o---o---
---------?---------T---X-?-------o--BB-------------------X-B-----------B--B--X------o--|-|-M-----B---?BM-----B-T-B-B-B---o---o-----M-------Bo-oB---------B-?B--T---?---T---B-----------E---XBo-----B-BT-
------M---?---M----B--B-B-----o-----------X---------B-----?--B--T-B---------B-----B-B-B----B----T--|----T---|---?--B------T---------------o---X-----------T---------oB----M-o---M-|-|--B--M---X-------Xv
-X-o---o---X-X-o-o---M-T---------------X-------|-M-X---------------B-X---o--T--------T-?BX---X---B-----?-M-M----B------M---M---B-B----BM-T-------------------------------T-o---B-----B----B--o---------f
--o---T---B-B-B---------|-E-T-----X---------------B-T---M---?---------X-----T-T-B-------------------|-----B--TT-----------------T-----------------M-----?------------B--B-----|---|---o---TBB---------Bf
--M--T----M-----BM-------X-M-M-B-E-T---T-B-X-T-----|B--------?--BT-|---X-?-BB---BT----BB-o---T-B-----B--??-o-?-XB--B------o------------?-T-B----T----B-T-B---o----BB---------T-----o-------?-------?-B-f
----B-X-B-----M-?-|---|-----B---T-?-----?-------XBo---E--BX-----XT--B-----------?o---?--B------B---B--------MB--X-B---o---T-B-B---o---o-B-B-----|-------M-B---BEM-B-EBB-T-----B---B-M-M---M-B----------f
---o---?---|---B-B----E|-T-----?---T--------X?-B-------X-?-------B-------XT--------------X-?-T---M--oX-?-X---------X---?-B---B---M-----B-E----o|B--B-B---B-X-B---M-|-|-------B-?-----|---------T-------f
----B---B---|---------M-----B-X----------o----X---------X---------E-B-X---B-?---B?B-----X---|---B-T-M---------X--B?---?------BB-----M-?-B---------X-?-----B------------------BB-M---B-T-B-T-B--B----M-Bf
m----------B-------B---------------X---BB---B--T-----X-----B--------------XB-----|---B-B--B-B-TB-----M---B-------o----B------------T---o---T-----T-M---B-------X--B----XB----X-o------------BB---------X
XXXXX--X-XXXX-X----X-XXXXX-X-XXXXXXXX-XXXXX-XBXX-XXXXXXXXXXXXT-XXX-XXXXXXXX-XXXXXXXXXX--XXXXXXXX-XXXXX-XXXXXX--XXXXXX-XXXXXXXXXX-XXXXXXXXXMXXXXXXXXXXXX-X-XX-EXXXXXXX--XXXXXXXXX-XoXX-XX-X-XXo-XXXX-XXXX
