-----To----------------------------------------T--M-------------------------------------------------?--------------B--------------o---X-------?--------------------------------------?------M-----------
----o-----------------------------------------E------?------------------T--------B-------------------------------------B------------------------o-----------X-?---------|--------------B---o-------o----
-------B-|------------B-------------B--------TB-----B-----B--------Xo-BM----------M-B-----B--------?----B-----------BX--T-----B--T--B---T----X--B-------------------------------------------------------
--------B----------------B---?-----------------B----|B----?-B--XB--X---B--X----------------Bo--B----BB----?---------o---B-M-?----B---B--|--M--B----B-----------B--------B------B---M--------------------
-----M---B---X------------X---------BX---T-------|--BB------B-?-------B---E-----B----|---------o------------?-o-----------o---o-------B----|--Bo------?----E--------B----|--------B--------------B-ME---
-------B--M--o------B----B--------?-T----------------X---------B-o--X-----TB------??------------------T-X----T-----------Bo--------o-----------------X---------B--------------T-------------------------
---------X----B-M--X--?-----------B-----B-B-B---M---B?--------B-----B------B---------------?------------B---BX--------------B---B---------------------------------B-------------T-B----|B---------------
-?---X--------X--------B---------------------o------------Bo----B--------E--------T----BB------------B-T-----o-B-----B--------X-Bo-B------------BB---X------X--B-------B--------T---------T-----------Mv
-?------------------------------------M-------------------------B-o-----------B-----------------BE-----XB---B------X-----o?-------------------B-----------B----------|---X------B-B-B?-----------------f
-B------------------?B-B---------------B-------B---------?---------------To-B--------B-------TX--M-----B---EB--------------B-------------B--?-----|--T-T----------------|B-----------------B---------B-f
--M---T-----o----?--X-T-B---B--TT----------?----BT--B---B|---------------M----B--------------X-----|B--------?B---------------o-B--------------------M-M-------------T----B---B---B-?-----B------------f
-----BM-M-------X-----M---------B--B---B-----B-----B-------------B-B----BB-------B-----------T---------------?-------------------------B-B-------------X---------------------|--------T----------------f
------------------B---B--------oB-B----T-----------------B---------X-------------------oB?---?-----XTX-----------?T-------B---B-----B----X----B------------------B----B-B-------------B-----T----------f
-----------B---o--X-E-BB-B---------B---------B------?--------B----M-X--------------M--------TB--X-X-M---------X---|---T-----T---E--------------Bo---X---?B---------B-B--T------------BX----oB--B-------f
m--------T--B----------M-----------------------|-----------B---X------------------B---------B--X-TB-------------o-BB--------X-----------------------B---------------------------o-X-B-B---B-B-------B--X
XXX--XXXX-X-XX--XXXX----XX-XXXXXXXXXXXX-XXX--X-XXXXX-X-XTXXXXXXX-XXXXXXXXXX-XX-X-X-MXXXXX?XX-XXXXXXXTXX-X-BX---XXXXX-XXXE--XBXXXX-XXXX--XXXXX-XXXXXXXXXXXXXXXXoXXXX-XXX--X-XMBXXX-XXXXXX-XXXX-XX-XMXX-XX
