-----------------M-------------------------------o----M----------------------------------------------------------------------o--------------------------------------------------------------------------
--------------------E--------------------Xo------------------------------------M--------T----------------------------------------------o----------------------------?--------X--------------------------
------------------o----------X----------------T---------B-------------------------------T---------------?--------------------------------X------------------o---T---------------------------------------
--------------------------------------T-------T---------------------?-------X---------?--------------------------------------------------------------------T----M--T--o---------M----------o------------
---------------------------------B----M----------E----------B--X-----------X--o----------------------------------------------------------------------------X-------T------------------M-----------------
-------o----------------B--------------------------------------------------o-----------------------------------E----------------?-------------------o---------------------X----------X------------------
--------?-----------X--------------------------------------------B-X----B---------------o-------------------------------------M-----M--------------------------------------------------------B-------o--
--------------------------------------E------------------------------o---------------------------------------------o-B-------------o--------B--------------M-------------------------X-----------------v
----o------------------B-----------------------------------------------B----M------T----------------------------E-----------B------------E---------X------------------------M-------------------X------f
------------EE-?-----o-M------------T---------------o------------------------------|----------B------------?-E----------------------------------------E-----------------E-----o--------------------E---f
-----B-------------------------E----X----------------------------B-----------------|--------------------X----M--B----------o--------------------------------------------------------X------------------f
-----------------E------X-o-T------------------------------------------------------X------------X-o--------------B---M--------------------------------------------E------------------?----------M-o----f
------E--------o------------T-------E------?T----------------------o----T-----------------------------------------------------------------------------------------?-----------------------------------Ef
--------------------------------------------T---------------------------B------------------o-------------------------------T-------------------------------------o----------------------o--------------f
m----------------X--------------------------------------------------------------------------?------------------------------|---------------o--o-------------------------X-----------------X------------X
XXXXX-XXXX-XX-XXX-XXXXXX-XXXXXXXXXXXX-XXXXXX-XEXXXXXXXXXXXXXXXXXX-?XXXXXXTXXXXXXXXXXXXXBXXXXX-XXXXXXXXXXXXXXXXXXXXXXoX-XXXXXX-XXXXXXXXXXXXXXXXXXXXXXXXXXXXBXXoXX?XXXXXXXXXXXXXXoXXXXXXXXXX-XXXXXXXXXX?XX
