--------?-------------------------------X----TB----------------T-----------------------B------------------X---------------B--B----B------------BE--------o---------X------B-------------------------T---
--M-B----B----------------------------o--B---B-----------------B--|-------B------?T-----T----------oX---B-oB-------B-M|------B--o---------MM--------------------B-----------------B--B----|-----T---|oX-
---------B-----?-T-------T----B--?-----------?-M-M-----?--------o-B------BM-------B-----B-----------T-B-B-----o--B----T-----------B-----T-BMB----------B---E-X-BB-B--------------?T-------BX--B-B--|B-B-
-----o---B-X---B-BM------B--------M---B--T---M-------B-B-----B----B-X--B-----B--X----B--------------X-X------B-B----T-X---------B---B---MBB-------T---------XB-----T--------------M-----T-M-----M--BXB--
---ET-----------------------------B-----XM--B-------o-BXB----BX---BT--B---B-----BTBX---|T---B-BM----B--------MBo---MB-B-X---M-?-?-o-----?-B--M-|----M-B------|B----M----B---B---o-B-----BMB-B|B---M-T---
----?---------T-----------X?---B---B----?B--T-----TB--T---E--------B-----B-----B-B-B-B-B----|--------------M-?T-M---------o---------X-?--B--|-BB--TBB--------B-B|BEB----E--------B----X--B---B------BB--
---XB----B----B---B----T-T----B---B-o-------B-B-BBB---B---B---------XT--B------|--------B---B-----T---B---B---B---?-------TM-X------T-B|M---B-B--MB----M-B-X----BB--------------------------------?-B---
----|----------E-------T-B--M-M-----MB----?---T--B----T-----o-|------B---------B-----B-B|----oX--oT-------o---TB--X---?--M?------B--T--B----|------------B---B---B-B---B----------------M------o-B---BBv
----B---------?|-------T----B---E----TB-----B-B-o-----B----XB-B------B--B--|---M--B--X-------T---|B--------B--B--XBX---|--B--MT-----B--M---oB---------B--T---T--B-B--?B-B--|?-----------------BT------Bf
---B----B------B--?-?-|B------M-X----B--------E------B-------------B------?B-B-------------T-BT--B---------------------B-----BX--------B--T-----?--B-----B---B----T--------B-----------MT--o-M-B-------f
------------X----BB?B-B-B-B---B-B--?----------------B--o------TXBB----B----|---------TB-B--|BXB--BE------------------M--BBB---B-B---E-----B----T-oBT--T--XB-------B---T-BB--------?|----B------X---?B--f
---B--?--MTX----T--BM-?----------------BT---------------|-----B--BoB-------B---B---B-BT---oB--T--B?B------XT-B-----------B--?--B------o---M----BX--B-E??-------------B|---T--------B-----T--?B-B-B-----f
---?-oB|--B----BB-B--|------------------B----T-----M---B?X---TB-----------------T-----B-B-----BB---X--B-B--X--B-B------T----M-------------o|----------B---------B--?--B---B-----ToTE-----X-----|-------f
-------B---B---B---B-B---------B-B-E-EB-----|B----B-M-TE?X?--B-----B-----B---B-TT-M--------B-B------T-----EM--B----TB--B----T---------|-E--B-B------o-Xo-B--?----BX------B------B-M------B-----B---B---f
m-B---B--------------|----B-B---B---------o-B---BB----B?------B-B----X--T--E---?--B|------------X---B-------B-B---M----XB--BB------BB-B------?-------MB----MB-----X-----o---B--?B-B---oo-----X---------X
X--X---X-XXX--XXXBXXXTXXX---XTX-XXTX----XXXXX----X-X-XXX--X--XXX-BXXX-XXX-XX-BX-XX-XX----X--X--X--X---XB-XBTXX--XXXX-XX--XXXXE-XMXX----XXX--XXXXX---BX------XX--XX-B-XXXoB-XXXXXX--oX-TX-X-X-X--o-X-XX-X
