-----------------M-------?-------------------------------------?----------------------?-E---------------------------T--o-----------------------------B------M-----?------X----------E------o------------
--M----------B--------------------oB---------------TT-T-o----------?E-----?------------?|----E---?--?---T----------TB-------------M-T-oB----?M-----------T------B-?---------------|-----------o-T--B----
---------B-----------X------------B---o-------?-M--?B-B-----B-oT-B--oTE-?---B---M-oM----B------B--------B----------BBM---T-------?B-B-------T--------T--BX-o-B--X-B-----M--X------B|-----Eo---TXM-------
--|B------M-XBX--BM-M--B-B---B----B---|-B---------XB------T----B---T-B-B-----------B-------?----------B--B---X-----BT----T--T------M---T----M-|-T----B---BM-----|-TBo--------T---?-B-----E|---MX|-------
--B---B-BX----------E----X--o-----oX--B-B---B----T--X-B-B-B-B--T---|----B-M---B-------------B-B|--B------T---?---T--B-M-BXB-B--?---BB-BXTT-MB-B-B-------X-B-----B?T-B----T---|----B-B-B--XB---B?T-BM----
---B-----Bo---M--oT-----E-B--B--EB---B--B------B-B-B-----M-----B-E|B---B---------B-T------E--?-B----|----BB----B-B-------B-B?--B-o-----?MB--M-|-TB-B--|----B------?-T-|-XB-M-B-----B-------TM-?-X-------
------B-------T---B----M---------------------o----TX----B---B?--XBT---------B------T---X-B----------T-----B--MB-BBo---------B-----------B-----B-B-o---B--M-XB---?-X-BBBT--B-BB---|--?------XT--------?--
----M----B----T----B--T-T-----X----o----X--B--|B--XB--------B--B--T-M----------MT--B--------?--T|?o-?-E-|X---B-BB---T-----------M--?-B---B-B-B-----B---B---BB----B-M---B----EBEB-B-o--M-T--B|oM--B---BMv
------B-----X-B-B-----B-B--T-------E------B---B---BTB?---M--------B---B--M--B---B-----B------TBXB---BB--B-----o----?T------M--------------E-B---------o--o----o-B--------|---X---|--?MB-B---B-B--------f
---B-M----o--------B--?-o--B--?BT-------?-E----B---B-B---------B---X-------M--------o------B-|-B?---?----M--X--B-o|B|----B-------------B-X--T----------------------B-?--?BT---M-TXEM--------B-M-T-B----f
-M-X-TB------T---B--B|----------B------?-------------------------X---------B-----M-------?-|-B------B-------B-XT--X-B-----X-B-B-o-TX--------B?---o-----------|-T-----T----BXB??-B------XB--M-B-BB|E----f
-B-BTB-----M-B|------B--------?BX----B--T----E----------------BB---------B-BB------------B-B-----??o----X------Bo-o-B---M-T-------M-EBB?------M------------E-B-B-MBE-B----TB---o-B-----B---X---B?B-----f
--T-Bo--B-T---B----o--------------B-----Bo---------------o--T--?----B?---BB--M----B--T-o--------?-------BM-------M---|--B-BM-----B--?-BX-B--?-M--T-E-------B-?-X----------B--o--B------X--BT---?B--?---f
--T-------?--------------BT-?---MB---B--|-E-----?-?--T-X--|-?------B--------?B--?----T-T--------B------B-B-XX-------MB----B-?----T-B-TTB---B--?--B-E-------B-B--T---X--X--X----X-B----o-BB-B--------M--f
m-B--M-X-?B--E------X---B-B-BXo-EX------T--E-T---T---X----B-T-B-------------B------M-|-M------------B-----------B-B--o----E-B----X---|BM--o--o-----o------B-----B-B----T--B?--------------T-?-B--------X
X-XX--XXX-XXX-X--XXT-X-EXBX--XXX-XX-oX---XXX-X-o-BXX-X-XX---X-EXX---X--XX--X---XXXTXXB-BXX-X-XXXX--X--o--X--XXXX--XEX--X--XXXXM-XX-BXB--XXX-X--X--X--XXX-Xo--o---X--XXXBXX-XX--XXXX-X-XXX--XXX-B--E-oXXX
